1	1	1	1	1	1	1	1	1	1	1	1	1	1	1	1	1	1	1	1	1	1	1	1	1	1	1	1	1	1	1	1	1	1	1	1	1	1	1	1
1	1	1	1	1	1	1	1	1	1	1	1	1	1	1	1	1	1	1	1	1	1	1	1	1	1	1	1	1	1	1	1	1	1	1	1	1	1	1	1
1	1	1	1	1	1	1	1	1	1	1	1	1	1	1	1	1	1	1	1	1	1	1	1	1	1	1	1	1	1	1	1	1	1	1	1	1	1	1	1
1	1	1	1	1	1	1	1	1	1	1	1	1	1	1	1	1	1	1	1	1	1	1	1	1	1	1	1	1	1	1	1	1	1	1	1	1	1	1	1
1	1	1	1	1	1	1	1	1	1	1	1	1	1	1	1	1	1	1	1	1	1	1	1	1	1	1	1	1	1	1	1	1	1	1	1	1	1	1	1
1	1	1	1	1	1	1	1	1	9	9	9	9	9	9	9	9	9	9	9	9	9	9	9	9	9	9	9	9	9	9	1	1	1	1	1	1	1	1	1
1	1	1	1	1	1	1	1	7	0	0	0	0	0	0	0	0	0	0	0	0	0	0	0	0	0	0	0	0	0	0	8	1	1	1	1	1	1	1	1
1	1	1	1	1	1	1	7	0	0	0	0	0	0	0	0	0	0	0	0	0	0	0	0	0	0	0	0	0	0	0	0	8	1	1	1	1	1	1	1
1	1	1	1	1	1	7	0	0	0	0	0	0	0	0	0	0	0	0	13	0	0	0	0	0	0	0	0	0	0	0	0	0	8	1	1	1	1	1	1
1	1	1	1	1	5	0	0	0	0	0	0	0	0	0	0	0	0	0	0	0	0	0	0	0	0	0	0	0	0	0	0	0	0	6	1	1	1	1	1
1	1	1	1	1	5	0	0	0	0	0	0	0	0	0	0	0	0	0	0	0	0	0	0	0	0	0	0	0	0	0	0	0	0	6	1	1	1	1	1
1	1	1	1	1	5	0	0	0	0	0	13	0	0	0	0	0	0	0	0	0	0	0	0	0	0	0	0	13	0	0	0	0	0	6	1	1	1	1	1
1	1	1	1	1	5	0	0	0	0	0	0	0	0	0	0	0	0	0	0	0	0	0	0	0	0	0	0	0	0	0	0	0	0	6	1	1	1	1	1
1	1	1	1	1	5	0	0	0	0	0	0	0	0	0	0	0	0	0	0	0	0	0	0	0	0	0	0	0	0	0	0	0	0	6	1	1	1	1	1
1	1	1	1	1	5	0	0	0	0	0	0	0	0	0	0	0	0	0	14	0	14	0	0	0	0	0	0	0	0	0	0	0	0	6	1	1	1	1	1
1	1	1	1	1	5	0	0	0	0	0	0	0	0	0	0	0	0	14	0	15	0	0	0	0	0	0	0	0	0	0	0	0	0	6	1	1	1	1	1
1	1	1	1	1	5	0	0	0	0	0	0	0	0	0	0	0	15	0	15	0	14	15	0	0	0	0	0	0	0	0	0	0	0	6	1	1	1	1	1
1	1	1	1	1	5	0	0	0	0	0	0	0	0	0	0	15	15	14	14	0	15	0	0	0	0	0	0	0	0	0	0	0	0	6	1	1	1	1	1
1	1	1	1	1	5	0	0	0	0	0	0	0	0	0	0	0	0	0	15	14	14	0	0	0	0	0	0	0	0	0	0	0	0	6	1	1	1	1	1
1	1	1	1	1	5	0	0	0	0	0	0	0	0	0	0	14	14	14	0	0	0	0	0	0	0	0	0	0	0	0	0	0	0	6	1	1	1	1	1
1	1	1	1	1	5	0	0	0	0	0	0	0	0	0	14	0	0	0	15	14	0	0	0	0	0	0	0	0	0	0	0	0	0	6	1	1	1	1	1
1	1	1	1	1	5	0	0	0	0	0	0	0	0	0	0	0	15	0	0	0	0	14	0	0	0	0	0	0	0	0	0	0	0	6	1	1	1	1	1
1	1	1	1	1	5	0	0	0	0	0	0	0	0	0	14	14	0	14	0	14	0	0	0	0	0	0	0	0	0	0	0	0	0	6	1	1	1	1	1
1	1	1	1	1	5	0	0	0	0	0	0	0	0	0	0	0	0	0	14	0	15	14	15	0	0	0	0	0	0	0	0	0	0	6	1	1	1	1	1
1	1	1	1	1	5	0	0	0	0	0	0	0	0	0	15	0	14	0	15	0	0	0	0	0	0	0	0	0	0	0	0	0	0	6	1	1	1	1	1
1	1	1	1	1	5	0	0	0	0	0	0	0	0	0	0	15	0	0	14	15	14	14	0	0	0	0	0	0	0	0	0	0	0	6	1	1	1	1	1
1	1	1	1	1	5	0	0	0	0	0	0	0	0	0	0	0	15	15	0	14	0	0	0	0	0	0	0	0	0	0	0	0	0	6	1	1	1	1	1
1	1	1	1	1	5	0	0	0	0	0	13	0	0	0	15	0	0	0	15	0	0	0	0	0	0	0	0	13	0	0	0	0	0	6	1	1	1	1	1
1	1	1	1	1	5	0	0	0	0	0	0	0	0	0	0	14	15	14	0	0	0	0	0	0	0	0	0	0	0	0	0	0	0	6	1	1	1	1	1
1	1	1	1	1	5	0	0	0	0	0	0	0	0	0	0	0	0	0	0	0	0	0	0	0	0	0	0	0	0	0	0	0	0	6	1	1	1	1	1
1	1	1	1	1	5	0	0	0	0	0	0	0	0	0	0	0	15	0	0	0	0	0	0	0	0	0	0	0	0	0	0	0	0	6	1	1	1	1	1
1	1	1	1	1	10	2	0	0	0	0	0	0	0	0	0	0	0	0	13	0	0	0	0	0	0	0	0	0	0	0	0	0	3	11	1	1	1	1	1
1	1	1	1	1	1	10	2	0	0	0	0	0	0	0	0	0	0	0	0	0	0	0	0	0	0	0	0	0	0	0	0	3	11	1	1	1	1	1	1
1	1	1	1	1	1	1	10	2	0	0	0	0	0	0	0	0	0	0	0	0	0	0	0	0	0	0	0	0	0	0	3	11	1	1	1	1	1	1	1
1	1	1	1	1	1	1	1	10	4	4	4	4	4	4	4	4	4	4	4	4	4	4	4	4	4	4	4	4	4	4	11	1	1	1	1	1	1	1	1
1	1	1	1	1	1	1	1	1	1	1	1	1	1	1	1	1	1	1	1	1	1	1	1	1	1	1	1	1	1	1	1	1	1	1	1	1	1	1	1
1	1	1	1	1	1	1	1	1	1	1	1	1	1	1	1	1	1	1	1	1	1	1	1	1	1	1	1	1	1	1	1	1	1	1	1	1	1	1	1
1	1	1	1	1	1	1	1	1	1	1	1	1	1	1	1	1	1	1	1	1	1	1	1	1	1	1	1	1	1	1	1	1	1	1	1	1	1	1	1
1	1	1	1	1	1	1	1	1	1	1	1	1	1	1	1	1	1	1	1	1	1	1	1	1	1	1	1	1	1	1	1	1	1	1	1	1	1	1	1
1	1	1	1	1	1	1	1	1	1	1	1	1	1	1	1	1	1	1	1	1	1	1	1	1	1	1	1	1	1	1	1	1	1	1	1	1	1	1	1